*********
*       *
*   **  *
**  *   *
*   **  *
*********
