************************************************************
*                        **************      ********     **
***                                         ******        **
*                    ************** ******          ********
*  ***    ********           *********      ****           *
******   ********    ****   *********       ****     *******
***     ********     *****                  ****     *******
*      ********      **************    *****          ******
****   *******                ****                **********
****   *******       *************                **********
***    *******                                    **********
*****   *******          ****************           ********
***      *******             *********             *********
*                                                          *
*******        ***********************************         *
*********   **********     ***********************       ***
*                            ******************    *    ****
******                                             *   *****
******    *********************************           ******
*            ****************       ***************     ****
************************************************************
